R 1920 800
NO ./textures/north.xpm
SO ./textures/south.xpm
WE ./textures/west.xpm
EA ./textures/east.xpm

S ./textures/orangefish.xpm

F 16,255,3
C 0,76,211

      111111111111111111111
      100000000011000000001
      101100000111000020001
      100100000020000000201111
111111111011020000111000020001
100022000011002000111011111111
11110002000000011110000010001
11110000000000011110101010001
1000000110101001110000010201
102000E0000000000110000010201
10002220020000000010101010201
110000001101010101111011101011
111101111111010101  101 101011
11111111 111111111  111 111111
