R 1600 900

NO textures/NO.xpm
SO textures/SO.xpm
WE textures/WE.xpm
EA textures/EA.xpm
S textures/pillar.xpm

F 16,255,3
C 0,76,211

      111111111111111111111
      100000000011000000001
      101100000111000020001
      100000000000000000201111
111111111011020000111000020001
100022000011002000111011111111
11110000001111011110000010001
11110111111111011110101000001
11200000110101011110000010201
100002E0000000000110000010201
10000010030000000000101010201
112200011101010101111011101011
11110111 111010101  101 101011
11111111 111111111  111 111111
