R 1920 800
NO ./textures/NO.xpm
SO ./textures/south.xpm
WE ./textures/WE.xpm
EA ./textures/east.xpm

S ./textures/orangefish.xpm
F 153,153,153
C 0,204,255

111111111111111
100000000000001
100000020000001
100010000010001
100000000000001
1002000S0002001
100000000000001
100000000000001
100011000001101
100000000200001
111111111111111
11111
