R 1920 800
NO ./textures/NO.xpm
SO ./textures/south.xpm
WE ./textures/WE.xpm
EA ./textures/east.xpm

S ./textures/orangefish.xpm
F 220,100,0
C 225,30,0

111111111111111
100000000000001
100000020000001
100010000010001
100000000000001
1002000W0002001
100000000000001
100000000000001
100011000001101
100000000200001
111111111111111
11111
