R 1920 800
NO ./textures/north.xpm
SO ./textures/south.xpm
WE ./textures/west.xpm
EA ./textures/east.xpm

S ./textures/orangefish.xpm
F 153,153,153
C 0,204,255

111111111111111
100000000000001
100000000000001
100000000000001
100000000000001
1000000N0000001
100000000000001
100000000000001
100000000000001
100000000000001
111111111111111
11111
