111111111111111
100000000011011
101100000111N11
100100000000011
111111111011011
100000000011011
111101111111111
111101111111111
110000001101011
100010000000011
111111111111111