R 1920 1080
NO ./path_to_the_north_texture
SO ./path_to_the_south_texture
WE ./path_to_the_west_texture
EA ./path_to_the_east_texture
S ./path_to_the_sprite_texture
F 220,100,0
C 225,30,0
111111111111111
100000000011011
101100000111011
100100000000011
111111111011011
100000000011011
111101111111111
111101111111111
110000001101011
100010000000011
111111111111111